Naranja	Bronce	Amarillo	Rojo
Cereza
Rojo	Violeta	Cereza	Naranja
Amarillo	Naranja	Crema	Arena
Bronce	Oro
Violeta	Azul	Lila
Bordo	Naranja	Rojo	Negro
Blanco	Amarillo	Rojo
Crema	Blanco
Oro	Bronce	Amarillo	Plata
Negro	Azul	Gris
Gris	Negro	Blanco	Oro	Plata
Plata	Plata
Lila	Magenta	Azul
Azul	Blanco	Negro
Arena	Oro	Agua
Rosa	Cyan	Lila
Magenta	Rosa
Cyan	Celeste	Azul
Celeste	Azul	Agua	Plata
Agua	Arena